0000000000000000
0999999999999990
0999999999999990
0999999999999990
0999999969999998
0999990300000000
0999999399999990
0999999399999990
0499999399999990
0000000000000000